{
  "id": "maze_0011",
  "width": 21,
  "height": 21,
  "start": [
    1,
    1
  ],
  "goal": [
    19,
    19
  ],
  "grid": [
    "#####################",
    "#S#.........#.......#",
    "#.###.####..#.####..#",
    "#.#...#.....#...#...#",
    "#.#.###.#########.#.#",
    "#.#...#...........#.#",
    "#.###.#######.#####.#",
    "#.....#.#...........#",
    "####.##.#.#..##.#.###",
    "#.....#.#.#.......#.#",
    "##..#.#.#.#...###.#.#",
    "#...#.#...#.#.#...#.#",
    "#.###.###.#.###.###.#",
    "#...............#...#",
    "#...#...#.###.#.#.#.#",
    "#.#.....#...#.#...#.#",
    "#.#.#########.#####.#",
    "#.#...........#.....#",
    "#.###########.#.#####",
    "#..................G#",
    "#####################"
  ]
}
