{
  "id": "maze_0018",
  "width": 27,
  "height": 27,
  "start": [
    1,
    1
  ],
  "goal": [
    25,
    25
  ],
  "grid": [
    "###########################",
    "#S..............#.........#",
    "#####...#####.#.#.#.#####.#",
    "#.....#.#.....#...#.....#.#",
    "#.#######.##..###.#.##..#.#",
    "#.#.......#.........#.....#",
    "#.#.###.#######.###.#.###.#",
    "#.#.#.........#.#.....#...#",
    "#.#.#.#.#.###.#.####.##.#.#",
    "#...#.......#.#...#.....#.#",
    "###...#######.#.#.#.##.##.#",
    "#...#.#.......#.#.#.......#",
    "#.###.#.#.##.##.#.#.#.###.#",
    "#.#...#.........#...#.....#",
    "#.###.....#####.##.##.#.###",
    "#...#...#.#...#.....#.#...#",
    "###.#.#.#.#.#.#####.#.###.#",
    "#.#.#.#.#...#.....#.#...#.#",
    "#.#.###.#.###.###.#.#####.#",
    "#.#...#...#.......#.......#",
    "#.###.#.###.#.#.####.####.#",
    "#...#.#.#...#.#.#.......#.#",
    "#.###.#.#.###.#.#.#.#.#.#.#",
    "#.........#...#.#.#.#...#.#",
    "#.#.#.#########.#.#.#####.#",
    "#.#.............#.#......G#",
    "###########################"
  ]
}
