{
  "id": "maze_0017",
  "width": 25,
  "height": 25,
  "start": [
    1,
    1
  ],
  "goal": [
    23,
    23
  ],
  "grid": [
    "#########################",
    "#S#...................#.#",
    "#.#.###.#.#####.#####.#.#",
    "#.......#...#.......#...#",
    "#.##.####.#.####..#.###.#",
    "#.#...........#...#...#.#",
    "#.#.#.###.###.#.#.#.#.#.#",
    "#.#.#...#.#...#.#.#.#...#",
    "#.#.#.#.#.#.#.#.###.#.###",
    "#.....#...#.#...#...#...#",
    "#.###.#.###.#.###.###...#",
    "#.....#.#...#...#...#.#.#",
    "#..##.#.#.###.#.###.#.#.#",
    "#...#...#.....#...#...#.#",
    "###.#######.#.#.#.#####.#",
    "#.#.#...#...#.#.#.#.#...#",
    "#.#...#.#.#####.#...#.###",
    "#.#...#.#.#.....#...#.#.#",
    "#.#####.#...#.###.###...#",
    "#.....#.....#.#...#...#.#",
    "#.##.###.##...###.#.###.#",
    "#.........#.#...#.#.#...#",
    "#.#.#.###.#.###.###.###.#",
    "#...#.........#........G#",
    "#########################"
  ]
}
