{
  "id": "maze_0020",
  "width": 31,
  "height": 31,
  "start": [
    1,
    1
  ],
  "goal": [
    29,
    29
  ],
  "grid": [
    "###############################",
    "#S..#.........#.............#.#",
    "###.#.#######.#.#####.#####.#.#",
    "#.#.#.....#.#.......#.#.......#",
    "#.#.#.#.#.#.#.##..###.#####.#.#",
    "#.#.#...#.#.........#.......#.#",
    "#.#.#####.#.#.#.###.######..#.#",
    "#.#...#.#...#.#.#.....#.....#.#",
    "#.###.#.#####.#.#####...###.#.#",
    "#.....#.....#.......#.#.#.....#",
    "#.#.#.##.##.#.#####.....#...###",
    "#.#.#.....#...#...#.#...#.#.#.#",
    "#.#######.#.###...#.#####.#.#.#",
    "#.........#.....#.#.....#.....#",
    "#.#######.#######.#####.#.#.#.#",
    "#.#...................#...#.#.#",
    "#.#.#.########.######.###.#.#.#",
    "#.#.#...#...........#.#...#...#",
    "#.#.#.###.#######.###.#.#####.#",
    "#...#...........#.#...#.....#.#",
    "###.#.#.#####.#.#.#.#####.#.###",
    "#...#.#...........#.#.....#...#",
    "#.#.#.#.#.#..##.###.#.#.#####.#",
    "#.#.....#.....#.....#.#.....#.#",
    "#.#####.##.##.####.##.#####...#",
    "#.#...#.....#...........#.#...#",
    "#.#...###.#.##.###.####.#.##..#",
    "#...#.#...............#.#.....#",
    "#####.#######.######..#.#.###.#",
    "#............................G#",
    "###############################"
  ]
}
