{
  "id": "maze_0007",
  "width": 17,
  "height": 17,
  "start": [
    1,
    1
  ],
  "goal": [
    15,
    15
  ],
  "grid": [
    "#################",
    "#S....#.........#",
    "#.###.#.#######.#",
    "#...#.........#.#",
    "###.#.###.#####.#",
    "#...#.#...#.....#",
    "#.#.###.#.#.###.#",
    "#.#.....#...#.#.#",
    "#.##.##.#.###.#.#",
    "#.............#.#",
    "#.#######.#####.#",
    "#.#.....#.......#",
    "#.##.##.#########",
    "#.......#.......#",
    "#######.###.###.#",
    "#...........#..G#",
    "#################"
  ]
}
