{
  "id": "maze_0019",
  "width": 29,
  "height": 29,
  "start": [
    1,
    1
  ],
  "goal": [
    27,
    27
  ],
  "grid": [
    "#############################",
    "#S......#.#...........#.....#",
    "######..#.#.#.#####.#.####..#",
    "#...#...#...#.......#.......#",
    "#.#.#.#######.#######...###.#",
    "#.#.#.#.....#.#...........#.#",
    "###.#.#.#.#.#.###.#######...#",
    "#...#...#...#...#.....#...#.#",
    "#.#.###.#.###...#####.#.#.###",
    "#.#.#.....#.#...#.....#.....#",
    "#.###.#####.#.#.#.#.###.#.#.#",
    "#.....#...#...#...#...#...#.#",
    "#..####.#.#..##.#.###.###.#.#",
    "#.......#.....#.#.#.....#.#.#",
    "#####.###.###.###.#.#.#...#.#",
    "#.#.................#...#.#.#",
    "#.#.#.#.#.#########.#.###...#",
    "#.#...#...........#...#...#.#",
    "#.#.#.#.##.####..##.###.#.#.#",
    "#.#.....#.........#.......#.#",
    "#...#.#.#.##..###...###.###.#",
    "#.#.......#...........#.#...#",
    "#.###.#.#.######.####.#.#.#.#",
    "#.......#.#.......#...#.#.#.#",
    "#.#.###.#.#.#.###.#.#.###.#.#",
    "#...#.#...#.#...#.........#.#",
    "#.#...#.###.#.#.###.###.###.#",
    "#.....#.......#............G#",
    "#############################"
  ]
}
