{
  "id": "maze_0015",
  "width": 23,
  "height": 23,
  "start": [
    1,
    1
  ],
  "goal": [
    21,
    21
  ],
  "grid": [
    "#######################",
    "#S................#...#",
    "#..##..#######.##.###.#",
    "#.......#.............#",
    "#.#.###.#.##.##.#####.#",
    "#.#.#.........#.......#",
    "#.###.###.#.#.#.##.##.#",
    "#.....#...#.#.#.....#.#",
    "#.#####.#.#.#.#####.#.#",
    "#.......#.#.#.......#.#",
    "#######.###.#######.#.#",
    "#...#...#...#.#.....#.#",
    "#.#.#####.###.#.#####.#",
    "#.#.......#...........#",
    "#.###.#####.##.##.#####",
    "#...#.......#.........#",
    "#.#.###.###.#.#.###.#.#",
    "#.#...#...........#.#.#",
    "#.###.#####.#.#.#.#.#.#",
    "#.#.#.#...#.#...#...#.#",
    "#.#.#...#.###.#.#####.#",
    "#...#...#............G#",
    "#######################"
  ]
}
