{
  "id": "maze_0008",
  "width": 19,
  "height": 19,
  "start": [
    1,
    1
  ],
  "goal": [
    17,
    17
  ],
  "grid": [
    "###################",
    "#S..#.#...........#",
    "###.#...#######.###",
    "#...#.....#...#...#",
    "#..##.#####.#.###.#",
    "#...........#.....#",
    "#.##.##########.#.#",
    "#...............#.#",
    "#.#.###...###.###.#",
    "#.....#.#.#...#...#",
    "#.###.#...#.###.#.#",
    "#...#.#...#.#.....#",
    "#.###.###.#.###...#",
    "#.....#...#...#.#.#",
    "#.#.#########.###.#",
    "#.#.....#...#...#.#",
    "#.#####.#.#.###.#.#",
    "#.....#...#......G#",
    "###################"
  ]
}
