{
  "id": "maze_0009",
  "width": 19,
  "height": 19,
  "start": [
    1,
    1
  ],
  "goal": [
    17,
    17
  ],
  "grid": [
    "###################",
    "#S#...............#",
    "#.#.#######.#####.#",
    "#.#.....#...#...#.#",
    "#.#.##.##.#.#...###",
    "#.#.#...#.....#...#",
    "#.###.#.#.#.###.#.#",
    "#.....#.#.#.......#",
    "##.##.#.#.#.#.#.###",
    "#.....#.#.....#...#",
    "#.#.###.########..#",
    "#.#.......#.......#",
    "#.###.###.#.#.#.#.#",
    "#.#.....#.#...#...#",
    "###.##.##.###.#.###",
    "#...#...#.#...#...#",
    "#..##.#...#.###...#",
    "#................G#",
    "###################"
  ]
}
