{
  "id": "maze_0001",
  "width": 15,
  "height": 15,
  "start": [
    1,
    1
  ],
  "goal": [
    13,
    13
  ],
  "grid": [
    "###############",
    "#S....#.......#",
    "#.###.###.###.#",
    "#...#.........#",
    "#.#.##..###.#.#",
    "#...#...#...#.#",
    "#.#.#.###.###.#",
    "#.#.#.#...#.#.#",
    "#.###.#.###.#.#",
    "#.....#.#.....#",
    "#.#####.#.#####",
    "#.......#.#...#",
    "#...#####.#.#.#",
    "#...#.......#G#",
    "###############"
  ]
}
